111111111111111111111
100000001111111111101
100000000000000000001
100010001111111111101
100010000000000000001
111111111111111111111